{
    "name": "map0",
    "size": [
        20,
        20
    ],
    "map": [
        [0,0,0,0,0,0,0,0,0,0,0,0,0,0,0,0,0,0,0,1],
        [0,0,0,0,0,0,0,0,0,0,0,0,0,0,0,0,0,0,1,1],
        [0,0,0,0,0,0,0,0,0,0,0,0,0,0,0,0,0,0,0,1],
        [0,0,0,0,0,0,0,0,0,0,0,0,0,0,0,0,0,1,0,1],
        [0,0,0,0,0,0,0,0,0,0,0,0,0,0,0,0,0,1,0,1],
        [0,0,0,0,0,0,0,0,0,0,0,0,0,0,0,0,0,1,0,1],
        [0,0,0,0,0,0,0,0,0,0,0,0,0,0,0,0,1,0,0,1],
        [0,0,0,0,0,0,0,0,0,0,0,0,0,0,0,0,1,0,0,1],
        [0,0,0,0,0,0,0,0,0,0,0,0,0,0,0,0,1,0,0,1],
        [0,0,0,0,0,0,0,0,0,0,0,0,0,0,0,0,0,0,0,1],
        [0,0,0,0,0,0,0,0,0,0,0,0,0,0,0,0,0,0,0,1],
        [0,0,0,0,0,0,0,0,0,0,0,0,0,0,0,0,0,0,0,1],
        [0,0,0,0,0,0,0,0,0,0,0,0,0,0,0,0,0,0,0,1],
        [0,0,0,0,0,0,0,0,0,0,0,0,0,0,0,0,0,0,0,1],
        [0,0,0,0,0,0,0,0,0,0,0,0,0,0,0,0,0,0,0,1],
        [0,0,0,0,0,0,0,0,0,0,0,0,0,0,0,0,0,0,0,1],
        [0,0,0,0,0,0,0,0,0,0,0,0,0,0,0,0,0,0,0,1],
        [0,0,0,0,0,0,0,0,0,0,0,0,0,0,0,0,0,0,0,1],
        [0,0,0,0,0,0,0,0,0,0,0,0,0,0,0,0,0,0,0,1],
        [1,1,1,1,1,1,1,1,1,1,1,1,1,1,1,1,1,1,1,1]
    ],
    "player": [30,300]
}