{
    "name": "map0",
    "size": [
        20,
        20
    ],
    "map": [
        [1,1,1,1,1,1,1,1,1,1,1,1,1,1,1,1,1,1,1,1],
        [1,0,0,0,0,0,0,0,0,0,0,0,0,0,0,0,0,0,1,1],
        [1,0,0,0,0,0,0,0,0,0,0,0,0,0,0,0,0,0,0,1],
        [1,0,0,0,0,0,0,0,0,0,0,0,0,0,0,0,0,2,0,1],
        [1,0,0,0,0,0,0,0,0,0,0,0,0,0,0,0,0,2,0,1],
        [1,0,0,0,0,0,0,0,0,0,0,0,0,0,0,0,0,2,0,1],
        [1,0,0,0,0,0,0,0,0,0,0,0,0,0,0,0,1,0,0,1],
        [1,0,0,0,0,0,0,0,0,0,0,0,0,0,0,0,1,0,0,1],
        [1,0,0,0,0,0,0,0,0,0,0,0,0,0,0,0,1,0,0,1],
        [1,0,0,0,0,0,0,0,0,0,0,0,1,0,0,0,0,0,0,1],
        [1,0,0,0,0,0,0,0,0,0,0,0,1,0,0,0,0,0,0,1],
        [1,0,0,0,0,0,0,0,0,0,0,0,1,0,0,0,1,0,0,1],
        [1,0,0,0,0,0,0,0,0,0,0,0,1,0,0,0,1,0,0,2],
        [1,0,0,0,0,0,0,0,0,0,0,0,1,0,0,0,1,0,0,2],
        [1,0,0,0,0,0,0,0,0,0,0,0,1,0,0,0,1,0,0,2],
        [1,0,0,0,0,0,0,0,0,0,0,0,0,0,0,0,0,0,0,2],
        [1,0,0,0,0,0,0,0,0,0,0,0,0,1,0,1,0,0,0,1],
        [1,0,0,0,0,0,0,0,0,0,0,0,0,0,0,1,0,0,0,1],
        [1,0,0,0,0,0,0,0,0,0,0,0,0,0,1,0,0,0,0,1],
        [1,1,1,1,1,1,1,1,1,1,1,1,1,1,1,1,1,1,1,1]
    ],
    "tiles": {
        "1"
        : "t1.png",
        "2": "t2.png"
    },
    "player": [30,300],

    "enemies": [
        [100,100],
        [200,200],
        [300,300]
    ]
}