{
    "tileMap": [
        [1,1,1,1,1,1,1,1,1,1,1,1,1,1,1,1,1,1,1,1],
        [1,0,0,0,0,0,0,0,0,0,0,0,0,0,0,0,0,0,1,1],
        [1,0,0,0,0,0,0,0,0,0,0,0,0,0,0,0,0,0,0,1],
        [1,0,0,0,0,0,0,0,0,0,0,0,0,0,0,0,0,2,0,1],
        [1,0,0,0,0,0,0,0,0,0,0,0,0,0,0,0,0,2,0,1],
        [1,0,0,0,0,0,0,0,0,0,0,0,0,0,0,0,0,2,0,1],
        [1,0,0,0,0,0,0,0,0,0,0,0,0,0,0,0,2,0,0,1],
        [1,0,0,0,0,0,0,0,0,0,0,0,0,0,0,0,2,0,0,1],
        [1,0,0,0,0,0,0,0,0,0,0,0,0,0,0,0,2,0,0,1],
        [1,0,0,0,0,0,0,0,0,0,0,0,1,0,0,0,0,0,0,1],
        [1,0,0,0,0,0,0,0,0,0,0,0,1,0,0,0,0,0,0,1],
        [1,0,0,0,0,0,0,0,0,0,0,0,1,0,0,0,1,0,0,1],
        [1,0,0,0,0,0,0,0,0,0,0,0,1,0,0,0,1,0,0,2],
        [1,0,0,0,0,0,0,0,0,0,0,0,1,0,0,0,1,0,0,2],
        [1,0,0,0,0,0,0,0,0,0,0,0,1,0,0,0,1,0,0,2],
        [1,0,0,0,0,0,0,0,0,0,0,0,0,0,0,0,0,0,0,2],
        [1,0,0,0,0,0,0,0,0,0,0,0,0,1,0,1,0,0,0,1],
        [1,0,0,0,0,0,1,0,0,0,0,1,0,0,0,1,0,0,0,1],
        [1,0,0,0,1,0,0,0,1,0,0,0,0,0,1,0,0,0,0,1],
        [1,1,1,1,1,1,1,1,1,1,1,1,1,1,1,1,1,1,1,1]
    ],
    "playerStartPos": [50, 50],
    "enemies": [
        [100, 350, 0],
        [150, 50, 1]
    ],
    "doorPos": [360,340]
}
