{
    "tileMap": [
        [1402,1402,1402,1301,1402,1402,1402,1402,1402,1402,1402,1402,1402,1402,1402,1402,1402,1402,1402,1402,1402,1402,1402,1402],
        [1402,   0,   0,   0,   0,   0,   0,   0,   0,   0,   0,   0,   0,   0,   0,   0,   0,   0,   0,   0,   0,   0,   0,1402],
        [1402,   0,   0,   0,   0,   0,   0,   0,   0,   0,   0,   0,   0,   0,   0,   0,   0,   0,   0,   0,   0,   0,   0,1402],
        [1402,   0,   0,   0,   0,   0,   0,   0,   0,   0,   0,   0,   0,   0,   0,   0,   0,   0,   0,   0,   0,   0,   0,1402],
        [1402,   0,   0,   0,   0,   0,   0,   0,   0,   0,   0,   0,   0,   0,   0,   0,   0,   0,   0,   0,   0,   0,   0,1402],
        [1402,   0,   0,   0,   0,   0,   0,   0,   0,   0,   0,   0,   0,   0,   0,   0,   0,   0,   0,   0,   0,   0,   0,1402],
        [1402,   0,   0,   0,   0,   0,   0,   0,   0,   0,   0,   0,   0,   0,   0,   0,   0,   0,   0,   0,   0,   0,   0,1402],
        [1402,   0,   0,   0,   0,   0,   0,   0,   0,   0,   0,   0,   0,   0,   0,   0,   0,   0,   0,   0,   0,   0,   0,1402],
        [1402,   0,   0,   0,   0,   0,   0,   0,   0,   0,   0,   0,   0,   0,   0,   0,   0,   0,   0,   0,   0,   0,   0,1402],
        [1402,   0,   0,   0,   0,   0,   0,   0,   0,   0,   0,   0,   0,   0,   0,   0,   0,   0,   0,   0,   0,   0,   0,1402],
        [1402,   0,   0,   0,   0,   0,   0,   0,   0,   0,   0,   0,   0,   0,   0,   0,   0,   0,   0,   0,   0,   0,   0,1402],
        [1402,   0,   0,   0,   0,   0,   0,   0,   0,   0,   0,   0,   0,   0,   0,   0,   0,   0,   0,   0,   0,   0,   0,1402],
        [1301,   0,   0,   0,   0,   0,   0,   0,   0,   0,   0,   0,   0,   0,   0,   0,   0,   0,   0,   0,   0,   0,   0,1402],
        [1301,   0,   0,   0,   0,   0,   0,   0,   0,   0, 311, 321, 331,   0,   0,   0,   0,   0,   0,   0,   0,   0,   0,1402],
        [1301,   0,   0,   0,   0,   0,   0,   0,   0,   0,   0,   0,   0,   0,   0,   0,   0,   0,   0,   0,   0,   0,   0,1301],
        [1301,   0,   0,   0, 501, 301, 301, 101,   0,   0,   0,   0,   0,   0,   0,   0,   0,   0,   0,   0,   0,   0,   0,1301],
        [1301,   0,   0,   0,   0,   0,   0,   0,   0,   0,   0,   0,1603,1703,1703,1633,   0,   0,   0, 111,   0,   0,   0,1301],
        [1301,   0,   0,   0,   0,   0,   0,   0,   0,   0,   0,   0,1713,1503,1523,1733,   0,   0,   0, 311,   0,   0,   0,1301],
        [1301,1301,1301,1301,1301,1301,1301,1301,1301,1301,1301,1301,1301,1301,1301,1301,1301,1301,1301,1301,1301,1301,1301,1301]
        ],
    "playerStartPos": [50, 200],
    "enemies": [
        [100, 200, 0],
        [150, 50, 1]
    ],
    "doorPos": [320,256]
}