{
    "tileMap": [
        [1301,1301,1301,1301,1301,1301,1301,1301,1301,1301,1301,1301,1301,1301,1301,1301,1301,1301,1301,1301,1301,1301,1301,1301,1301,1301,1301,1301,1301,1301,1301,1301,1301,1301,1301,1301,1301,1301,1301,1301,1301,1301,1301,1301,1301,1301,1301,1301,1301,1301,1301,1301,1301,1301,1301,1301,1301,1301,1301,1301,1301,1301,1301,1301,1301,1301,1301,1301,1301,1301,1301,1301],
        [1301,1301,1301,1301,1301,1301,1301,1301,1301,1301,1301,1301,1301,1301,1301,1301,1301,1301,1301,1301,1301,1301,1301,1301,1301,1301,1301,1301,1301,1301,1301,1301,1301,1301,1301,1301,1301,1301,1301,1301,1301,1301,1301,1301,1301,1301,1301,1301,1301,1301,1301,1301,1301,1301,1301,1301,1301,1301,1301,1301,1301,1301,1301,1301,1301,1301,1301,1301,1301,1301,1301,1301],
        [1301,1503,1533,1523,1733,   0,   0,   0,   0,   0,   0,   0,   0,1523,1513,1523,1533,1533,1523,1513,1503,1503,1513,1503,1503,1513,1513,1503,1503,1513,1503,1503,1513,1513,   0,   0,   0,   0,   0,   0,   0,   0,   0,1523,1513,1523,   0,   0,   0,   0,   0,   0,   0,   0,   0,   0,   0,   0,   0,   0,   0,   0,   0,   0,   0,   0,   0,   0,   0,   0,1301,1301],
        [1301,1503,1533,1523,1733,   0,   0,   0,   0,   0,   0,   0,   0,1523,1513,1523,1533,1533,1523,1513,1503,1503,1513,1503,1503,1513,1513,1503,1503,1513,1503,1503,1513,1513,   0,   0,   0,   0,   0,   0,   0,   0,   0,1523,1513,1523,   0,   0,   0,   0,   0,   0,   0,   0,   0,   0,   0,   0,   0,   0,   0,   0,   0,   0,   0,   0,   0,   0,   0,   0,1301,1301],
        [1301,1503,1533,1523,1733,   0,   0,   0,   0,   0,   0,   0,   0,1523,1513,1523,1533,1533,1523,1513,1503,1503,1513,1503,1503,1513,1513,1503,1503,1513,1503,1503,1513,1513,   0,   0,   0,   0,   0,   0,   0,   0,   0,1523,1513,1523,   0,   0,   0,   0,   0,   0,   0,   0,   0,   0,   0,   0,   0,   0,   0,   0,   0,   0,   0,   0,   0,   0,   0,   0,1301,1301],
        [1301,1503,1533,1523,1733,   0,   0,   0,   0,   0,   0,   0,   0,1523,1513,1523,1533,1533,1523,1513,1503,1503,1513,1503,1503,1513,1513,1503,1503,1513,1503,1503,1432,1513,   0,   0,   0,   0,   0,   0,   0,   0,   0,1523,1513,1523,   0,   0,   0,   0,   0,   0,   0,   0,   0,   0,   0,   0,   0,   0,   0,   0,   0,   0,   0,   0,   0,   0,   0,   0,1301,1301],
        [1301,1503,1533,1523,1733,   0,   0,   0,   0,   0,   0,   0,   0,1523,1513,1523,1533,1533,1523,1513,1503,1503,1513,1503,1503,1513,1513,1503,1503,1513,1503,1503,1513,1513,   0,   0,   0,   0,   0,   0,   0,   0,   0,   0,1523,1513,1523,   0,   0,   0,   0,   0,   0,   0,   0,   0,   0,   0,   0,   0,   0,   0,   0,   0,   0,   0,   0,   0,   0,   0,1301,1301],
        [1301,1503,1533,1523,1733,   0,   0,   0,   0,   0,   0,   0,   0,1523,1513,1523,1533,1533,1523,1513,1503,1523,1513,1503,1503,1513,1513,1503,1503,1513,1503,1503,1513,1513,   0,   0,   0,   0,   0,1412,1432,   0,   0,   0,1523,1513,1523,   0,   0,   0,1422,   0,   0,   0,   0,   0,   0,   0,   0,   0,   0,   0,   0,   0,   0,   0,   0,   0,   0,   0,1301,1301],
        [1301,1503,1533,1523,1733,   0,   0,   0,   0,   0,   0,   0,   0,1523,1513,1523,1533,1402,1523,1513,1503,1503,1513,1503,1503,1513,1513,1503,1503,1513,1503,1503,1513,1513,   0,   0,   0,   0,1422,   0,   0,   0,   0,   0,1523,1513,1523,   0,   0,   0,1321,1321,1422,   0,   0,   0,   0,   0,   0,   0,   0,   0,   0,   0,   0,   0,   0,   0,   0,   0,1301,1301],
        [1301,1503,1533,1523,1733,   0,   0,1101, 901, 701,   0,   0,   0,1523,1513,1523,1533,1533,1523,1513,1503,1503,1513,1503,1503,1513,1432,1503,1503,1513,1503,1503,1513,1513,   0,   0,   0,   0,1422,1412,1432,   0,   0,1523,1513,1523,   0,   0,   0,   0,1311,   0,1422,1301,   0,   0,   0,   0,   0,   0,   0,   0,   0,   0,   0,   0,   0,   0,   0,   0,1301,1301],
        [1301,1503,1533,1523,1733,   0,   0,   0,   0,   0,   0,   0,   0,   0,   0,   0,   0,   0,   0,   0,   0,   0,   0,   0,   0,   0,   0,   0,   0,   0,   0,   0,   0,   0,   0,   0,   0,   0,   0,1422,1412,   0,1523,1513,1523,   0,   0,   0,   0,   0,   0,   0,1321,   0,   0,   0,   0,   0,   0,   0,   0,   0,   0,   0,   0,   0,   0,   0,   0,   0,1301,1301],
        [1301,1503,1533,1523,1733,   0,   0,   0,   0,   0,   0,   0,   0,   0,   0,   0,   0,   0,   0,   0,   0,   0,   0,   0,   0,   0,   0,   0,   0,   0,   0,   0,   0,   0,   0,   0,   0,   0,1422,1412,   0,   0,   0,1523,1513,1523,   0,   0,   0,   0,   0,   0,1321,   0,   0,   0,   0,   0,   0,   0,   0,   0,   0,   0,   0,   0,   0,   0,   0,   0,1301,1301],
        [1301,1503,1533,1523,1733,   0,   0,   0,   0,   0,   0,   0,   0,   0,   0,   0,   0,   0,   0,   0,   0,   0,   0,   0,   0,   0,   0,   0,   0,   0,   0,   0,   0,   0,   0,   0,   0,   0,   0,1412,1432,   0,   0,1523,1513,1523,   0,   0,   0,   0,1402,1402,1422,   0,   0,   0,   0,   0,   0,   0,   0,   0,   0,   0,   0,   0,   0,   0,   0,   0,1301,1301],
        [1301,1503,1533,1523,1733,   0,   0,   0,   0,   0,   0,   0,   0,   0,   0,   0,   0,   0,   0,   0,   0,   0,   0,   0,   0,   0,   0,   0,   0,   0,   0,   0,   0,   0,   0,   0,   0,   0,1422,   0,1432,   0,   0,   0,1523,1513,1523,   0,   0,   0,1301,   0,1301,   0,   0,   0,   0,   0,   0,   0,   0,   0,   0,   0,   0,   0,   0,   0,   0,   0,1301,1301],
        [1301,1503,1533,1523,1733,   0,   0,   0,   0,   0,   0,   0,   0,   0,   0,   0,   0,   0,   0,   0,   0,   0,   0,   0,   0,   0,   0,   0,   0,   0,   0,   0,   0,   0,   0,   0,   0,   0,   0,1412,1432,   0,   0,   0,   0,   0,   0,   0,   0,   0,1402,   0,1321,   0,   0,   0,   0,   0,   0,   0,   0,   0,   0,   0,   0,   0,   0,   0,   0,   0,1301,1301],
        [1301,1503,1533,1523,1733,   0,   0,   0,   0,   0,   0,   0,   0,   0,   0,   0,   0,   0,   0,   0,   0,   0,   0,   0,   0,   0,   0,   0,   0,   0,   0,   0,   0,   0,   0,   0,   0,   0,1422,1412,1432,   0,   0,   0,   0,   0,   0,   0,   0,   0,1422,   0,1402,   0,   0,   0,   0,   0,   0,   0,   0,   0,   0,   0,   0,   0,   0,   0,   0,   0,1301,1301],
        [1301,1503,1533,1523,1733,   0,   0,   0,   0,   0,   0,   0,   0,   0,   0,   0,   0,   0,   0,   0,   0,   0,   0,   0,   0,   0,   0,   0,   0,   0,   0,   0,   0,   0,   0,   0,   0,   0,   0,1412,   0,   0,   0,   0,   0,   0,   0,   0,   0,   0,1321,   0,1422,   0,   0,   0,   0,   0,   0,   0,   0,   0,   0,   0,   0,   0,   0,   0,   0,   0,1301,1301],
        [1301,1503,1533,1523,1733,   0,   0,   0,   0,   0,   0,   0,   0,   0,   0,   0,   0,   0,   0,   0,   0,   0,   0,   0,   0,   0,   0,   0,   0,   0,   0,   0,   0,   0,   0,   0,   0,   0,1422,1412,1432,   0,   0,   0,   0,   0,   0,   0,   0,   0,1301,   0,1422,   0,   0,   0,   0,   0,   0,   0,   0,   0,   0,   0,   0,   0,   0,   0,   0,   0,1301,1301],
        [1301,1503,1533,1523,1733,   0,   0,   0,   0,   0,   0,   0,   0,1402,1402,1301,1301,1301,1301,1301,1301,1301,1301,1301,1301,1301,1301,1301,1301,1301,1301,1301,1301,1301,1301,1301,1301,1301,1301,1301,1301,1301,1301,1301,1301,1301,1301,1301,1301,1301,1301,1301,1301,1301,1301,1301,1301,1301,1301,1301,1301,1301,1301,1301,1301,1301,1301,1301,1301,1301,1301,1301],
        [1301,1503,1533,1523,1733,   0,   0,   0,   0,   0,   0,   0,   0,1402,1301,1301,1301,1301,1301,1301,1301,1301,1301,1301,1301,1301,1301,1301,1301,1301,1301,1301,1301,1301,1301,1301,1301,1301,1301,1301,1301,1301,1301,1301,1301,1301,1301,1301,1301,1301,1301,1301,1301,1301,1301,1301,1301,1301,1301,1301,1301,1301,1301,1301,1301,1301,1301,1301,1301,1301,1301,1301],
        [1301,1503,1533,1523,1733,   0,   0,   0,   0,   0,   0,   0,   0,   0,   0,   0,   0,   0,   0,   0,   0,   0,   0,1301,1301,1301,   0,   0,   0,   0,   0,   0,   0,   0,   0,   0,   0,   0,   0,   0,   0,   0,   0,   0,   0,   0,   0,   0,1523,1513,1513,   0,   0,   0,   0,   0,   0,   0,   0,   0,   0,   0,   0,   0,   0,   0,   0,   0,   0,   0,1402,1301],
        [1301,1503,1533,1523,1733,   0,   0,   0,   0,   0,   0,   0,   0,   0,   0,   0,   0,   0,   0,   0,   0,   0,   0,1301,1301,1301,   0,   0,   0,   0,   0,   0,   0,   0,   0,   0,   0,   0,   0,   0,   0,   0,   0,   0,   0,   0,   0,   0,1523,1513,1513,   0,   0,   0,   0,   0,   0,   0,   0,   0,   0,   0,   0,   0,   0,   0,   0,   0,   0,   0,1301,1301],
        [1301,1503,1533,1523,1733,   0,   0,   0,   0,   0,   0,   0,   0,   0,   0,   0,   0,   0,   0,   0,   0,   0,   0,1301,1301,1301,   0,   0,   0,   0,   0,   0,   0,   0,   0,   0,   0,   0,   0,   0,   0,   0,   0,   0,   0,   0,   0,   0,1523,1513,1513,   0,   0,   0,   0,   0,   0,   0,   0,   0,   0,   0,   0,   0,   0,   0,   0,   0,   0,   0,1402,1301],
        [1301,1503,1533,1523,1733,   0,   0,   0,   0,   0,   0,   0,   0,   0,   0,   0,   0,   0,   0,   0,   0,   0,   0,1301,1301,1301,   0,   0,   0,   0,   0,   0,   0,   0,   0,   0,   0,   0,   0,1101, 701,   0,   0,   0,   0,   0,   0,   0,1523,1513,1513,   0,   0,   0,   0,   0,   0,   0,   0,   0,   0,   0,   0, 111,   0,   0,   0,   0,   0,   0,1301,1301],
        [1301,1503,1533,1523,1733,   0,   0,   0, 111,   0,   0,   0,   0,   0,   0,   0,   0,   0,   0,   0,   0,   0,   0,1301,1301,1301,   0,   0,   0,   0,   0,   0,   0,   0,   0,   0,1523,1513,1513,   0,   0,   0,   0,   0,   0,   0,   0,   0,1523,1513,1513,   0,   0,   0,   0,   0,   0,   0,   0,   0,   0,   0,   0, 911,   0,   0,   0,   0,   0,   0,1301,1301],
        [1301,1503,1533,1523,1733,   0,   0,   0, 311,   0,   0,   0,   0,   0,   0,   0,   0,   0,   0,   0,   0,   0,   0,1301,1301,1301,   0,   0,   0,   0,   0,   0,   0,   0,   0,   0,1523,1513,1513,   0,   0,   0,   0,   0,   0,   0,   0,   0,1523,1513,1513,   0,   0,   0,   0,   0,   0,   0,   0,   0,   0,   0,   0, 911,   0,   0,   0,   0,   0,   0,1301,1301],
        [1301,1503,1533,1523,1733,   0,   0,   0, 511,   0,   0,   0,   0,   0,   0,   0,   0,   0,   0,   0,   0,   0,   0,   0,   0,   0,   0,   0,   0,   0,   0,   0,   0,   0,   0,   0,1523,1513,1513,   0,   0,   0,   0,   0,   0,   0,   0,   0,1523,1513,1513,   0,   0,   0,   0,   0,   0,   0,   0,   0,   0,   0,   0, 311,   0,   0,   0,   0,   0,   0,1402,1301],
        [1301,1503,1533,1523,1733,   0,   0,   0,   0,   0,   0,   0,   0,   0,   0,   0,   0,   0,   0,   0,   0,   0,   0,   0,   0,   0,   0,   0,   0,   0,   0,   0,   0,   0,   0,   0,1523,1513,1513,   0,   0,   0,   0,   0,   0,   0,   0,   0,1523,1513,1513,   0,   0,   0,   0,   0,   0,   0,   0,   0,   0,   0,   0, 911,   0,   0,   0,   0,   0,   0,1402,1301],
        [1301,1503,1533,1523,1733,   0,   0,   0,   0,   0,   0,   0,   0,   0,   0,   0,   0,   0,   0,   0,   0,   0,   0,   0,   0,   0,   0,   0,   0,   0,   0,   0,   0,   0,   0,   0,1523,1513,1513,   0,   0,   0,   0,   0,   0,   0,   0,   0,1523,1513,1513,   0,   0,   0,   0,   0,   0,   0,   0,   0,   0,   0,   0, 911,   0,   0,   0,   0,   0,   0,1402,1301],
        [1301,1503,1533,1523,1733,   0,   0,   0,   0,   0, 501, 101,   0,   0,   0,   0,   0,   0,   0,   0,   0,   0,   0,   0,   0,   0,   0,   0,   0,   0,   0,   0,   0,   0,   0,   0,1523,1513,1513,   0,   0,   0,   0,   0,   0,   0,   0,   0,1523,1513,1513,   0,   0,   0,   0,   0,   0,   0,   0,   0,   0,   0,   0, 911,   0,   0,   0,   0,   0,   0,1402,1301],
        [1301,1503,1533,1523,1733,   0,   0,   0,   0,   0,   0,   0,   0,   0,   0,   0,   0,   0,   0,   0,   0,   0,   0,   0,   0,   0,   0,   0,   0,   0,   0,   0,   0,   0,   0,   0,1523,1513,1513,   0,   0, 501, 301, 101,   0,   0,   0,   0,1523,1513,1513,   0,   0,   0,   0,   0,   0,   0,   0,   0,   0,   0,   0, 313,   0,   0,   0,   0,   0,   0,1402,1301],
        [1301,1503,1533,1523,1733,   0,   0,   0,   0,   0,   0,   0,   0,   0,   0,   0,   0,   0,   0,   0,   0,   0,   0,   0,   0,   0,   0,   0,   0, 501, 301, 101,   0,   0,   0,   0,1523,1513,1513,   0,   0,   0,   0,   0,   0,   0,   0,   0,1523,1513,1513,   0,   0,   0,   0,   0,   0,   0,   0,   0,   0,   0,   0,1111,   0,   0,   0,   0,   0,   0,1301,1301],
        [1301,1503,1533,1523,1733,   0,   0,   0,   0,   0,   0,   0,   0,   0,   0,   0,   0,1523,1513,1513,1523,1513,1513,1523,1513,1513,1523,1513,1513,1523,1513,1513,   0,   0,   0,   0,1523,1513,1513,   0,   0,   0,   0,   0,   0,   0,   0,   0,   0,   0,   0,   0,   0,   0,   0,   0,   0,   0,   0,   0,   0,   0,   0,   0,   0,   0,   0,   0,   0,   0,1402,1301],
        [1301,1503,1533,1523,1733,   0,   0,   0,   0,   0,   0,   0,   0,   0,   0,   0,   0,1523,1513,1513,1523,1513,1513,1523,1513,1513,1523,1513,1513,1523,1513,1513,   0,   0,   0,   0,1523,1513,1513,   0,   0,   0,   0,   0,   0,   0,   0,   0,   0,   0,   0,   0,   0,   0,   0,   0,   0,   0,   0,   0,   0,   0,   0,   0,   0,   0,   0,   0,   0,   0,1402,1301],
        [1301,1503,1533,1523,1733,   0,   0,   0,   0,   0,   0,   0,   0,   0,   0,   0,   0,1523,1513,1513,1523,1513,1513,1523,1513,1513,1523,1513,1513,1523,1513,1513,   0,   0,   0,   0,1523,1513,1513,   0,   0,   0,   0,   0,   0,   0,   0,   0,   0,   0,   0,   0,   0,   0,   0,   0,   0,   0,   0,   0,   0,   0,   0,   0,   0,   0,   0,   0,   0,   0,1301,1301],
        [1301,1503,1533,1523,1733,   0,   0,   0,   0,   0,   0,   0,   0,   0,   0,   0,   0,1523,1513,1513,1523,1513,1513,1523,1513,1513,1523,1513,1513,1523,1513,1513,   0,   0,   0,   0,1523,1513,1513,   0,   0,   0,   0,   0,   0,   0,   0,   0,   0,   0,   0,   0,   0,   0,   0,   0,   0,   0,   0,   0,   0,   0,   0,   0,   0,   0,   0,   0,   0,   0,1402,1301],
        [1301,1301,1301,1301,1301,1301,1301,1301,1301,1301,1301,1301,1301,1301,1301,1301,1301,1301,1301,1301,1301,1301,1301,1301,1301,1301,1301,1301,1301,1301,1301,1301,1301,1301,1301,1301,1301,1301,1301,1301,1301,1301,1301,1301,1301,1301,1301,1301,1301,1301,1301,1301,1301,1301,1301,1301,1301,1301,1301,1301,   0,   0,   0,   0,   0,   0,   0,   0,   0,   0,1301,1301],
        [1301,1301,1301,1301,1301,1301,1301,1301,1301,1301,1301,1301,1301,1301,1301,1301,1301,1301,1301,1301,1301,1301,1301,1301,1301,1301,1301,1301,1301,1301,1301,1301,1301,1301,1301,1301,1301,1301,1301,1301,1301,1301,1301,1301,1301,1301,1301,1301,1301,1301,1301,1301,1301,1301,1301,1301,1301,1301,1301,1301,   0,   0,   0,   0,   0,   0,   0,   0,   0,   0,1402,1301],
        [1301,1301,   0,   0,   0,   0,   0,   0,   0,   0,   0,   0,   0,   0,   0,   0,   0,   0,   0,   0,   0,   0,   0,   0,   0,   0,   0,   0, 311,   0,   0,   0,   0,   0,1301,   0,   0,   0,   0,   0,   0,   0,   0,   0,   0,   0,   0,   0,   0,   0,   0,   0,   0,   0,   0,   0,   0,   0,   0,   0,   0,   0,   0,   0,   0,   0,   0,   0,   0,   0,1402,1301],
        [1301,1301,   0,   0,   0,   0,   0,   0,   0,   0,   0,   0,   0,   0,   0,   0,   0,   0,   0,   0,   0,   0,   0,   0,   0,   0,   0,   0, 311,   0,   0,   0,   0,   0,1301,   0,   0,   0,   0,   0,   0,   0,   0,   0,   0,   0,   0,   0,   0,   0,   0,   0,   0,   0,   0,   0,   0,   0,   0,   0,   0,   0,   0,   0,   0,   0,   0,   0,   0,   0,1301,1301],
        [1301,1301,   0,   0,   0,   0,   0,   0,   0,   0,   0,   0,   0,   0,   0,   0,   0,   0,   0,   0,   0,   0,   0,   0,   0,   0,   0,   0, 311,   0,   0,   0,   0,   0,1301,   0,   0,   0,   0,   0,   0,   0,   0,   0,   0,   0,   0,   0,   0, 602, 402, 202,   0,   0,   0,   0,   0,   0,   0,   0,   0,   0,   0,   0,   0, 501, 101,   0,   0,   0,1402,1301],
        [1301,1301,   0,   0,   0,   0,   0,   0,   0,   0,   0,   0,   0,   0,   0,   0,   0,   0,   0,   0,   0,   0,   0,   0,   0,   0,   0,   0, 311,   0,   0,   0,   0,   0,1301,   0,   0,   0,   0,   0,   0,   0,   0,   0,   0,   0,   0,   0,   0,   0,   0,   0,   0,   0,   0,   0,   0,   0,   0,   0,   0,   0,   0,   0,   0,   0,   0,   0,   0,   0,1402,1301],
        [1301,1301,   0,   0,   0,   0,   0,   0,   0,   0,   0,   0,   0,   0,   0,   0,   0,   0,   0,   0,   0,   0,   0,   0,   0,   0,   0,   0, 311,   0,   0,   0,1101, 901,1301,   0,   0,   0,   0,   0,   0,   0,   0,   0,   0,   0,   0,   0,   0,   0,   0,   0,   0,   0,   0,   0,   0,   0,   0,   0,   0,   0,   0,   0,   0,   0,   0,   0,   0,   0,1301,1301],
        [1301,1301,   0,   0,   0,   0,   0,   0,   0,   0,   0,   0,   0,   0,   0,   0,   0,   0,   0,   0,   0,   0,   0,   0,   0,   0,   0,   0, 311,   0,   0,   0,   0,   0,1301,   0,   0,   0,   0,   0,   0,   0,   0,1101, 901, 701,   0,   0,   0,   0,   0,   0,   0,   0,   0,   0,   0,   0,   0,   0,   0,   0,   0,   0,   0,   0,   0,   0,   0,   0,1301,1301],
        [1301,1301,   0,   0,   0,   0,   0,   0,   0,   0,   0,   0,   0,   0,   0,   0,   0,   0,   0,   0,   0,   0,   0,   0,   0,   0,   0,   0, 511,   0,   0,   0,   0,   0,1301,   0,   0,   0,   0,   0,   0,   0,   0,   0,   0,   0,   0,   0,   0,   0,   0,   0,   0,   0,   0,   0,   0,   0,   0,   0,   0,   0,   0,   0,   0,   0,   0,   0,   0,   0,1402,1301],
        [1301,1301,   0,   0,   0,   0,   0,   0, 501, 301, 301, 301, 301, 101,   0,   0,   0,   0,   0,   0,   0,   0,   0,   0,   0,   0,   0,   0,   0,   0,   0,   0,   0,   0,1301,   0,   0,   0,   0,   0,   0,   0,   0,   0,   0,   0,   0,   0,   0,   0, 501, 301, 301, 301, 301, 101,   0,   0,   0,   0,   0,   0,1101,701,   0,   0,   0,   0,   0,   0,1402,1301],
        [1301,1301,   0,   0,   0,   0,   0,   0,   0,   0,   0,   0,   0,   0,   0,   0,   0,   0,   0,   0,   0,   0,   0,   0,   0,   0,   0,   0,   0,   0,   0,   0,   0,   0,1301,   0,   0,   0,   0,   0,   0,   0,   0,   0,   0,   0,   0,   0,   0,   0,   0,   0,   0,   0,   0,   0,   0,   0,   0,   0,   0,   0,   0,   0,   0,   0,   0,   0,   0,   0,1402,1301],
        [1301,1301,   0,   0,   0,   0,   0,   0,   0,   0,   0,   0,   0,   0,   0,   0,   0,   0,   0,   0,   0,   0,   0,   0,   0,   0,   0,   0,   0,   0,   0,   0,   0,   0,1301,   0,   0,   0,   0,   0,   0,   0,   0,   0,   0,   0,   0,   0,   0,   0,   0,   0,   0,   0,   0,   0,   0,   0,   0,   0,   0,   0,   0,   0,   0,   0,   0,   0,   0,   0,1402,1301],
        [1301,1301,   0,   0,   0,   0,   0,   0,   0,   0,   0,   0,   0,   0,   0,   0,   0,   0,   0,   0,   0,   0,   0,   0,   0,   0,   0,   0,   0,   0,   0,   0,   0,   0,1301,   0,   0, 501, 301, 301, 301, 101,   0,   0,   0,   0,   0,   0,   0,   0,   0,   0,   0,   0,   0,   0,   0,   0,   0,   0,   0,   0,   0,   0,   0,   0,   0,   0,   0,   0,1402,1301],
        [1301,1301,   0,   0,   0,   0,   0,   0,   0,   0,   0,   0,   0,   0,   0,   0,   0,   0, 501, 301, 301, 301, 101,   0,   0,   0,   0,   0,   0,   0,   0,   0,   0,   0,1301,   0,   0,   0,   0,   0,   0,   0,   0,   0,   0,   0,   0,   0,   0,   0,   0,   0,   0,   0,   0,   0,   0,   0,   0,   0,   0,   0,   0,   0,   0,   0,   0,   0,   0,   0,1301,1301],
        [1301,1301,   0,   0,   0,   0,   0,   0,   0,   0,   0,   0,   0,   0,   0,   0,   0,   0,   0,   0, 711,   0,   0,   0,   0,   0,   0,   0,   0,   0,   0,   0,   0,   0,1301,   0,   0,   0,   0,   0,   0,   0,   0,   0,   0,   0,   0,1101, 901, 901, 901, 901, 701,   0,   0,   0,   0,   0,1603,1703,1703,1703,1703,1703,1703,1703,1703,1703,1703,1703,1301,1301],
        [1301,1301,   0,   0,   0,   0,   0,   0,   0,   0,   0,   0,   0,   0,   0,   0,   0,   0,   0,   0, 911,   0,   0,   0,   0,   0,   0,   0,   0,   0,   0,   0,   0,   0,   0,   0,   0,   0,   0,   0,   0,   0,   0,   0,   0,   0,   0,   0,   0,   0,   0,   0,   0,   0,   0,   0,   0,   0,1713,1503,1523,1503,1523,1503,1523,1503,1523,1503,1523,1523,1301,1301],
        [1301,1301,   0,   0,   0,   0,   0,   0,   0,   0,   0,   0,   0,   0,   0,   0,   0,   0,   0,   0, 911,   0,   0,   0,   0,   0,   0,   0,   0,   0,   0,   0,   0,   0,   0,   0,   0,   0,   0,   0,   0,   0,   0,   0,   0,   0,   0,   0,   0,   0,   0,   0,   0,   0,   0,   0,   0,   0,1713,1503,1523,1503,1523,1503,1523,1503,1523,1503,1523,1503,1301,1301],
        [1301,1301,   0,   0,   0,   0,   0,   0,   0,   0,   0,   0,   0,   0,   0,   0,   0,   0,   0,   0, 911,   0,   0,   0,   0,   0,   0,   0,   0,   0,   0,   0,   0,   0,   0,   0,   0,   0,   0,   0,   0,   0,   0,   0,   0,   0,   0,   0,   0,   0,   0,   0,   0,   0,   0,   0,   0,   0,1713,1503,1523,1503,1523,1503,1523,1503,1523,1503,1523,1503,1301,1301],
        [1301,1301,1301,1301,1301,1301,1301,1301,1301,1301,1301,1301,1301,1301,1301,1301,1301,1301,1301,1301,1301,1301,1301,1301,1301,1301,1301,1301,1301,1301,1301,1301,1301,1301,1301,1301,1301,1301,1301,1301,1301,1301,1301,1301,1301,1301,1301,1301,1301,1301,1301,1301,1301,1301,1301,1301,1301,1301,1301,1301,1301,1301,1301,1301,1301,1301,1301,1301,1301,1301,1301,1301],
        [1301,1301,1301,1301,1301,1301,1301,1301,1301,1301,1301,1301,1301,1301,1301,1301,1301,1301,1301,1301,1301,1301,1301,1301,1301,1301,1301,1301,1301,1301,1301,1301,1301,1301,1301,1301,1301,1301,1301,1301,1301,1301,1301,1301,1301,1301,1301,1301,1301,1301,1301,1301,1301,1301,1301,1301,1301,1301,1301,1301,1301,1301,1301,1301,1301,1301,1301,1301,1301,1301,1301,1301],
        [1301,1301,1301,1301,1301,1301,1301,1301,1301,1301,1301,1301,1301,1301,1301,1301,1301,1301,1301,1301,1301,1301,1301,1301,1301,1301,1301,1301,1301,1301,1301,1301,1301,1301,1301,1301,1301,1301,1301,1301,1301,1301,1301,1301,1301,1301,1301,1301,1301,1301,1301,1301,1301,1301,1301,1301,1301,1301,1301,1301,1301,1301,1301,1301,1301,1301,1301,1301,1301,1301,1301,1301]
    ],
    "playerStartPos": [50, 832],
    "enemies": [
    ],
    "doorPos": [320,256]
}